/*JSON[*/
// object name has to be the same as the filename!
Lucid.data.maps.map1 = {
	config: {
		id: "map1",
		type: Lucid.Engine.TYPE.SIDE_SCROLL,
		name: "Map 1",
		cols: 12,
		rows: 12,
		tileSize: 64,

		layers: [
			{
				config: {
					z: 10,
					id: "layer-background",
					cols: 12,
					rows: 12,
					type: Lucid.Layer.TYPE.GRAPHICAL,
					effects: [],
					data: [
						4, 4, 4, 4, 4, 4, 4, 4, 4, 4, 4, 4,
						4, 2, 2, 2, 2, 2, 2, 2, 2, 2, 2, 4,
						4, 2, 2, 2, 2, 2, 2, 2, 2, 2, 2, 4,
						4, 2, 2, 2, 2, 2, 2, 2, 2, 2, 2, 4,
						4, 2, 2, 2, 2, 2, 2, 2, 2, 2, 2, 4,
						4, 2, 2, 2, 2, 2, 3, 2, 2, 2, 2, 4,
						4, 2, 3, 3, 2, 2, 2, 2, 2, 2, 2, 4,
						4, 2, 3, 3, 2, 2, 2, 2, 2, 2, 2, 4,
						4, 2, 2, 2, 3, 2, 2, 2, 2, 2, 2, 4,
						4, 2, 2, 2, 2, 3, 2, 2, 2, 2, 2, 4,
						4, 2, 2, 2, 2, 3, 2, 2, 2, 2, 2, 4,
						4, 4, 4, 2, 2, 3, 4, 4, 4, 4, 4, 4
					]
				}
			},
			{
				config: {
					z: 11,
					id: "layer-objects",
					// TODO: I dont want to use cols / rows logic for objects...
					type: Lucid.Layer.TYPE.OBJECTS,
					effects: [],
					data: [
						// ...still need to think about this structure though!
					]
				}
			},
			{
				config: {
					z: 12,
					id: "layer-foreground",
					cols: 12,
					rows: 12,
					type: Lucid.Layer.TYPE.GRAPHICAL,
					effects: [],
					data: [
						5, 4, 4, 4, 4, 4, 4, 4, 4, 4, 4, 5,
						5, 0, 0, 0, 0, 0, 0, 0, 0, 0, 0, 5,
						5, 0, 0, 0, 0, 0, 0, 0, 0, 0, 0, 5,
						5, 0, 0, 6, 0, 0, 0, 0, 0, 6, 0, 5,
						5, 0, 0, 0, 0, 0, 0, 0, 0, 0, 0, 5,
						5, 0, 0, 0, 0, 0, 0, 0, 0, 0, 0, 5,
						5, 0, 0, 0, 0, 0, 0, 0, 0, 0, 0, 5,
						5, 0, 0, 0, 0, 0, 0, 0, 0, 0, 0, 5,
						5, 0, 0, 0, 0, 0, 0, 0, 0, 0, 0, 5,
						5, 0, 0, 0, 0, 0, 0, 0, 0, 0, 0, 5,
						5, 5, 5, 0, 6, 5, 5, 5, 5, 5, 5, 5,
						5, 5, 5, 0, 0, 4, 4, 4, 4, 4, 4, 4
					]
				}
			},
			{
				config: {
					z: 13,
					id: "layer-collision",
					cols: 12,
					rows: 12,
					type: Lucid.Layer.TYPE.COLLISION,
					effects: [],
					data: [
						1, 1, 1, 1, 1, 1, 1, 1, 1, 1, 1, 1,
						1, 0, 0, 0, 0, 0, 0, 0, 0, 0, 0, 1,
						1, 0, 0, 0, 0, 0, 0, 0, 0, 0, 0, 1,
						1, 0, 0, 0, 0, 0, 0, 0, 0, 0, 0, 1,
						1, 0, 0, 0, 0, 0, 0, 0, 0, 0, 0, 1,
						1, 0, 0, 0, 0, 0, 0, 0, 0, 0, 0, 1,
						1, 0, 0, 0, 0, 0, 0, 0, 0, 0, 0, 1,
						1, 0, 0, 0, 0, 0, 0, 0, 0, 0, 0, 1,
						1, 0, 0, 0, 0, 0, 0, 0, 0, 0, 0, 1,
						1, 0, 0, 0, 0, 0, 0, 0, 0, 0, 0, 1,
						1, 0, 0, 0, 0, 0, 0, 0, 0, 0, 0, 1,
						1, 1, 1, 0, 0, 1, 1, 1, 1, 1, 1, 1
					]
				}
			}
		]
	}
};
/*]JSON*/