/*JSON[*/
Lucid.data.maps.map1 = {
	config: {
		id: "map1",
		name: "Map 1",
		cols: 12,
		rows: 25,
		tileSize: 64,
		assetFilePath: "assets/map1_tiles.png",
		gravityX: 0,
		gravityY: 0,

		// layers
		layers: [
			{
				config: {
					z: 10,
					id: "layer-background",
					render: 1,
					type: Lucid.BaseLayer.TYPE.TILESET,
					data: [
						[0, 0, 0, 0, 0, 0, 0, 0, 0, 0, 0, 0],
						[4, 4, 4, 4, 4, 4, 4, 4, 4, 4, 4, 4],
						[4, 2, 2, 2, 2, 2, 2, 2, 2, 2, 2, 4],
						[4, 2, 2, 2, 2, 2, 2, 2, 2, 2, 2, 4],
						[4, 2, 2, 2, 2, 2, 2, 2, 2, 2, 2, 4],
						[4, 2, 2, 2, 2, 2, 2, 2, 2, 2, 2, 4],
						[4, 2, 2, 2, 2, 2, 3, 2, 2, 2, 2, 4],
						[4, 2, 3, 3, 3, 2, 2, 2, 2, 2, 2, 4],
						[4, 2, 3, 3, 2, 2, 2, 2, 2, 2, 2, 4],
						[4, 2, 2, 2, 3, 2, 2, 2, 2, 2, 2, 4],
						[4, 2, 2, 2, 2, 3, 2, 2, 2, 2, 2, 4],
						[4, 2, 2, 2, 2, 3, 2, 2, 2, 2, 2, 4],
						[4, 4, 4, 2, 2, 3, 2, 2, 4, 4, 4, 4],
						[4, 4, 3, 2, 2, 2, 3, 3, 4, 4, 4, 4],
						[4, 3, 3, 2, 2, 2, 2, 2, 2, 2, 2, 4],
						[4, 3, 2, 2, 2, 2, 2, 2, 2, 2, 2, 4],
						[4, 2, 2, 2, 2, 2, 2, 2, 2, 2, 2, 4],
						[4, 2, 2, 2, 2, 2, 2, 2, 2, 2, 2, 4],
						[4, 2, 2, 2, 2, 3, 3, 2, 2, 2, 2, 4],
						[4, 2, 2, 2, 3, 2, 2, 2, 2, 2, 2, 4],
						[4, 2, 2, 3, 2, 2, 2, 3, 2, 2, 2, 4],
						[4, 2, 2, 2, 3, 2, 2, 2, 2, 2, 2, 4],
						[4, 2, 2, 2, 2, 3, 2, 2, 2, 2, 3, 4],
						[4, 2, 2, 2, 2, 3, 2, 2, 2, 3, 3, 4],
						[4, 4, 4, 2, 2, 3, 4, 4, 4, 4, 4, 4]
					]
				}
			},
			{
				config: {
					z: 11,
					id: "layer-entities",
					render: 1,
					type: Lucid.BaseLayer.TYPE.ENTITIES,
					data: [
						{
							id: "passant1",
							componentName: "EntityPassant",
							x: 500,
							y: 200,
							colliding: 1,
							render: 1,
							snapToGrid: 1,
							team: 1,
							type: Lucid.BaseEntity.TYPE.UNIT
						},
						{
							id: "fighter1",
							componentName: "EntityFighter",
							x: 500,
							y: 400,
							colliding: 1,
							render: 1,
							snapToGrid: 1,
							team: 2,
							type: Lucid.BaseEntity.TYPE.UNIT
						},
						{
							id: "potion1",
							componentName: "EntityPotion",
							x: 470,
							y: 570,
							colliding: 1,
							render: 1,
							snapToGrid: 1,
							team: 0,
							type: Lucid.BaseEntity.TYPE.ITEM
						}
					]
				}
			},
			{
				config: {
					z: 13,
					id: "layer-foreground",
					render: 1,
					type: Lucid.BaseLayer.TYPE.TILESET,
					data: [
						[5, 5, 5, 5, 5, 5, 5, 5, 5, 5, 5, 5],
						[5, 0, 0, 0, 0, 0, 0, 0, 0, 0, 0, 5],
						[5, 0, 0, 0, 0, 0, 0, 0, 0, 0, 0, 5],
						[5, 0, 0, 0, 0, 0, 0, 0, 0, 0, 0, 5],
						[5, 0, 0, 6, 0, 0, 0, 0, 0, 6, 0, 5],
						[5, 0, 0, 6, 0, 0, 0, 0, 0, 0, 0, 5],
						[5, 0, 0, 6, 0, 0, 0, 0, 0, 0, 0, 5],
						[5, 0, 0, 6, 6, 0, 0, 0, 0, 0, 0, 5],
						[5, 0, 0, 6, 0, 0, 0, 0, 0, 0, 0, 5],
						[5, 0, 0, 6, 0, 0, 0, 0, 0, 0, 0, 5],
						[5, 0, 0, 0, 0, 0, 0, 0, 0, 0, 0, 5],
						[5, 5, 5, 0, 6, 0, 0, 0, 5, 5, 5, 5],
						[5, 5, 0, 0, 0, 0, 0, 0, 5, 5, 5, 5],
						[5, 0, 0, 0, 0, 0, 0, 0, 0, 0, 0, 5],
						[5, 0, 0, 0, 0, 0, 0, 0, 0, 0, 0, 5],
						[5, 0, 0, 0, 0, 6, 6, 6, 0, 0, 0, 5],
						[5, 0, 0, 0, 6, 0, 0, 0, 6, 0, 0, 5],
						[5, 0, 0, 6, 0, 0, 6, 0, 0, 6, 0, 5],
						[5, 0, 6, 0, 0, 6, 6, 0, 0, 6, 0, 5],
						[5, 6, 0, 0, 6, 0, 6, 0, 6, 0, 0, 5],
						[5, 0, 0, 6, 0, 0, 6, 0, 6, 0, 0, 5],
						[5, 0, 0, 0, 0, 0, 0, 0, 0, 6, 0, 5],
						[5, 0, 0, 0, 0, 0, 0, 0, 0, 0, 0, 5],
						[5, 5, 5, 0, 0, 0, 5, 5, 5, 5, 5, 5],
						[5, 5, 5, 0, 0, 0, 0, 0, 0, 0, 0, 0]
					]
				}
			},
			{
				config: {
					z: 14,
					id: "layer-collision",
					render: 1,
					type: Lucid.BaseLayer.TYPE.COLLISION,
					data: [
						[0, 0, 0, 0, 0, 0, 0, 0, 0, 0, 0, 0],
						[1, 1, 1, 1, 1, 1, 1, 1, 1, 1, 1, 1],
						[1, 0, 0, 0, 0, 0, 0, 0, 0, 0, 0, 1],
						[1, 0, 0, 0, 0, 0, 0, 0, 0, 0, 0, 1],
						[1, 0, 0, 1, 0, 0, 0, 0, 0, 1, 0, 1],
						[1, 0, 0, 1, 0, 0, 0, 0, 0, 0, 0, 1],
						[1, 0, 0, 1, 0, 0, 0, 0, 0, 0, 0, 1],
						[1, 0, 0, 1, 1, 0, 0, 0, 0, 0, 0, 1],
						[1, 0, 0, 1, 0, 0, 0, 0, 0, 0, 0, 1],
						[1, 0, 0, 1, 0, 0, 0, 0, 0, 0, 0, 1],
						[1, 0, 0, 0, 0, 0, 0, 0, 0, 0, 0, 1],
						[1, 0, 0, 0, 1, 0, 0, 0, 0, 0, 0, 1],
						[1, 1, 1, 0, 0, 0, 0, 0, 1, 1, 1, 1],
						[1, 1, 0, 0, 0, 0, 0, 0, 1, 1, 1, 1],
						[1, 0, 0, 0, 0, 0, 0, 0, 0, 0, 0, 1],
						[1, 0, 0, 0, 0, 1, 1, 1, 0, 0, 0, 1],
						[1, 0, 0, 0, 1, 0, 0, 0, 1, 0, 0, 1],
						[1, 0, 0, 1, 0, 0, 1, 0, 0, 1, 0, 1],
						[1, 0, 1, 0, 0, 1, 1, 0, 0, 1, 0, 1],
						[1, 1, 0, 0, 1, 0, 1, 0, 1, 0, 0, 1],
						[1, 0, 0, 1, 0, 0, 1, 0, 1, 0, 0, 1],
						[1, 0, 0, 0, 0, 0, 0, 0, 0, 1, 0, 1],
						[1, 0, 0, 0, 0, 0, 0, 0, 0, 0, 0, 1],
						[1, 0, 0, 0, 0, 0, 0, 0, 0, 0, 0, 1],
						[1, 1, 1, 1, 1, 1, 1, 1, 1, 1, 1, 1]
					]
				}
			}
		]
	}
};
/*]JSON*/